Actual - Fictional - Фактический -Вымышленный
Asleep - Awake - Спящий - Бодрствующий 
Beautiful - Ugly - Красивый - Уродливый 
Best - Worst - Лучше всего - Хуже всего 
Big - Little - Большой - Маленький 
Black - White - Черный - Белый 
Brave - Cowardly - Храбрый - Трусливый 
Bright - Dim - Яркий - Тусклый 
Cheap - Expensive - Дешевый - Дорогой 
Cheerful - Sad - Веселый - Грустный 
Clean - Dirty - Чистый - Грязный 
Clear - Blurry - Ясный - Мутный
Clever - Dumb - Умный - Глупый, немой 
Common - Rare - Обычный - Редкий 
Crazy - Sane - Сумасшедший - Нормальный 
Curved - Straight - Изогнутый - Прямой 
Dead - Alive - Мертвый - Живой 
Deep - Shallow - Глубокий - Поверхностный 
Dense - Thin - Плотный - Тонкий 
Different - Same - Различный - Такой же
Drink - Sober - Пьяный - Трезвый 
Empty - Full - Пустой - Полный 
Even - Odd - Чётный - Нечетный 
Exact - Approximate - Точный - Приблизительный 
Fast -  Slow - Быстрый - Медленный 
Fat - Thin - Жирный - Худой 
Final - Preliminary - Конечный - Предварительный 
First - Last - Первый - Последний 
Foreign - Domestic - Иностранный - Внутренний 
Fresh - Rotten - Свежий - Гнилой 
General - Particular - Общий - Частный 
Generous - Greedy - Щедрый - Жадный 
Gentle - Rough - Нежный - Грубый 
Gloomy - Cheerful  - Мрачный - Веселый  
Good - Bad - Хороший - Плохой 
Guilty - Innocent - Виновный - Невинный 
Hot - Cold - Горячий - Холодный 
Hard -Soft - Жесткий - Мягкий 
Hard - Easy - Трудный - Простой 
Hardworking - Lazy - Трудолюбивый - Ленивый 
Heavy - Light - Тяжёлый   - Лёгкий 
High - Low - Высокий - Низкий 
Honorable-Infamous - Благородный -позорный
Absence - Presence - Отсутствие - Присутствие 
Attraction - Repulsion - Влечение - Отвращение 
Beginning - End - Начало - Конец 
Birth - Death - Рождение - Смерть 
Bliss - Misery - Счастье - Страдание 
Center - Periphery - Центр - Периферия 
Change - Stability - Изменение - Стабильность 
Chief - Subordinate - Руководитель-Подчиненный 
Child - Adult - Ребенок - Взрослый 
Complaint - Praise - Жалоба - Похвала 
Copy - Original - Копия - Оригинал 
Delight - Disgust - Восхищение - Отвращение 
Flood - Drought - Наводнение - Засуха 
Floor - Ceiling - Пол - Потолок 
Freedom - Slavery - Свобода - Рабство 
Friend - Enemy - Друг - Враг 
Front - Back - Перед - Зад 
Frost - Heat - Мороз - Жара 
Future - Past - Будущее - Прошлое 
Giant - Pigmy - Гигант - Пигмей 
Glory - Disgrace - Слава - Позор 
Good - Evil - Добро - Зло 
Growth - Decay - Рост - Спад 
Guest - Host - Гость - Хозяин 
Health - Disease - Здоровье - Болезнь 
Hell - Paradise - Ад - Рай 
Honesty - Cheating - Честность - Обман 
Hope - Despair - Надежда - Отчаяние 
Joy - Grief - Радость - Горе 
Lie - Truth - Ложь - Правда 
Light - Darkness - Свет - Темнота 
Marriage - Divorce - Брак - Развод 
Part - Whole - Часть - Целое 
Pride - Shame - Гордость - Позор 
Reward - Punishment - Награда - Наказание 
Success - Failure - Успех - Неудача 
Supply - Demand - Поставка - Спрос 
Tension - Relaxation  - Напряженность - Расслабление  
Victory - Defeat - Победа - Поражение 
Top - Bottom - Вершина - Основание 
Virtue - Sin - Достоинство - Грех 
War - Peace	Война - Мир
Wisdom - Foolishness	Мудрость - Глупость
Add - Subtract - Добавить - Вычесть 
Argue - Agree - Спорить - Согласиться 
Arrive - Depart - Прибыть - Отбыть 
Ask - Answer - Спросить - Ответить 
Begin - Finish - Начать - Кончить 
Bend - Straighten - Изогнуть - Выпрямить 
Borrow - Return - Заимствовать - Возвращать 
Break - Repair - Разбить - Ремонтировать 
Build - Destroy - Строить - Разрушать 
Buy - Sell - Купить - Продать 
Care - Ignore - Заботиться - Игнорировать 
Catch - Let go - Ловить - Отпускать 
Change - Remain - Изменять - Ост-ть прежним 
Collect - Scatter - Собирать - Разбросать 
Come - Go - Приходить - Уходить 
Confuse - Clarify - Путать - Разъяснять 
Continue - Interrupt - Продолжить - Прерывать 
Connect - Tear - Соединить - Разорвать 
Decide - Hesitate - Решить - Сомневаться 
Divide - Multiply - Разделить - Умножить 
Drop - Pick up - Бросать - Собирать 
Earn - Spend - Заработать - Тратить 
Enjoy - Suffer - Наслаждаться - Страдать 
Enter - Exit - Войти - Выйти 
Fail - Pass - Провалить - Выдержать(экзамен) 
Fill - Empty - Заполнить - Опустошить 
Find - Lose - Найти - Потерять 
Float - Sink - Плавать - Тонуть 
Fly - Crawl - Лететь - Ползать 
Give - Take - Дать - Взять 
Hide -  Exhibit - Скрыть - Показать 
Hire - Fire - Нанять - Уволить
Hit - Miss - Попасть - Промахнуться 
Hurry - Delay - Спешить - Задерживать
Improve - Deteriorate - Улучшать - Ухудшать 
Increase - Decrease - Увеличить - Уменьшить 
Join - Separate - Объединить - Отделить 
Love - Hate - Любить - Ненавидеть 
Open - Close - Открыть - Закрыть 
Permit - Forbid - Позволять - Запрещать 
Remember - Forget - Помнить - Забыть 
Start - Stop - Стартовать - Остановить 
Win - Lose - Победить - Проиграть
Huge - Tiny	Огромный - Крошечный
Hungry - Full - Голодный - Сытый 
Intelligent - Stupid - Интеллектуальный - Глупый 
Interesting - Boring - Интересный - Скучный 
Kind - Cruel - Добрый - Жестокий 
Kind - Mean - Добрый - Жестокий 
Left - Right - Левый - Право 
Long - Short - Длинный - Короткий 
Loud - Quiet - Громкий - Тихий 
Major - Minor - Главный - Младший 
Natural - Artificial - Естественный - Искусственный 
Naked - Dressed - Голый - Одетый 
Near - Far - Близкий - Далекий 
Negative - Positive - негативный - позитивный 
New - Old - Новый - Старый 
Nice - Nasty - Милый - Противный 
Original - Banal - Оригинальный - Банальный 
Public - Private - Публичный - Частный 
Polite - Rude - Вежливый - Грубый 
Previous - Next - Предыдущий - След-ий 
Quiet - Noisy - Тихий - Шумный 
Real - Fake - Реальный - Фальшивый 
Rich - Poor - Богатый - Бедный 
Safe - Dangerous - Безопасный - Опасный 
Right - Wrong - Правый - Неправый 
Same - Different - Такой же - Отличный 
Severe -Mild - Строгий - Снисходит-ый 
Scarce - Plentiful - Скудный - Обильный 
Sharp - Blunt - Острый - Тупой 
Shy - Assertive - Застенчивый - Уверенный 
Simple - Complicated - Простой - Сложный 
Small - Large - Маленький - Большой 
Smooth - Rough - Гладкий - Грубый 
Strong - Weak - Сильный - Слабый 
Stubborn - Agreeable - Упрямый - Согласный 
Toll - Short - Высокий - Низкй
Thick - Thin - Толстый - Тонкий 
Tight - Loose - Тугой - Дряблый 
Transparent - Opaque - Прозрачный - Непрозрачный 
True - False - Истина - Ложь 
Warm - Cool - Теплый - Охлаждённый 
Wet - Dry - Влажный - Сухой 
Wide - Narrow - Широкий - Узкий